12	14	0	12	12	12	12	12	0	0	10	10	0	0	10	10	0	14	14	14	14	14	14	0	12	14
14	12	0	12	12	12	12	12	0	0	10	10	0	0	10	10	0	14	14	14	14	14	14	0	14	12
12	14	0	12	12	12	0	0	12	0	10	10	0	0	10	10	0	14	14	14	14	14	14	0	12	14
14	12	0	12	12	12	0	0	12	0	10	10	0	0	10	10	0	14	14	14	14	0	0	0	14	12
12	14	0	12	12	12	0	0	12	0	10	10	10	10	10	10	0	14	14	14	14	0	0	0	12	14
14	12	0	12	12	12	12	12	0	0	10	10	10	10	10	10	0	14	14	14	14	14	0	0	14	12
12	14	0	12	12	12	12	12	0	0	10	10	10	10	10	10	0	14	14	14	14	14	0	0	12	14
14	12	0	12	12	12	0	0	12	0	0	10	10	10	10	0	0	14	14	14	14	0	0	0	14	12
12	14	0	12	12	12	0	0	12	0	0	10	10	10	10	0	0	14	14	14	14	0	0	0	12	14
0	0	0	12	12	12	0	0	12	0	0	10	10	10	10	0	0	14	14	14	14	14	14	0	0	0
10	10	0	12	12	12	12	12	0	0	0	10	10	10	10	0	0	14	14	14	14	14	14	0	10	10
10	10	0	12	12	12	12	12	0	0	0	10	10	10	10	0	0	14	14	14	14	14	14	0	10	10